width 20
height 15
200.0 200.0 40.0 20.0 40.0 40.0 50.0 50.0
0 0 0 0 2 0 0 0 0 0 2 0 0 0 0 0 0 0 0 0
5 0 0 0 2 0 8 0 0 0 2 0 0 0 0 0 0 0 0 0
0 0 0 0 2 0 0 0 0 0 2 0 0 0 0 0 0 0 0 0
0 0 0 0 2 4 1 1 1 1 1 3 2 0 0 0 7 0 0 0
0 0 0 0 2 0 0 0 0 0 0 0 2 0 0 0 0 0 0 0
2 0 0 0 2 0 0 0 0 0 0 0 2 0 0 0 0 0 1 0
0 0 0 0 2 1 1 1 1 1 1 1 2 0 0 0 0 0 0 0
0 0 0 0 0 0 0 0 0 0 0 0 0 0 0 0 1 0 0 0
0 0 0 0 0 0 0 0 0 0 0 0 0 0 0 0 0 0 0 0
0 0 0 0 0 0 0 0 0 0 0 0 0 0 1 0 0 0 0 0
0 0 0 0 0 6 0 0 0 0 0 0 0 0 0 0 0 0 0 0
0 0 0 0 0 0 0 0 0 0 0 0 1 0 0 0 0 0 0 0
0 0 0 0 0 0 0 0 0 0 0 0 0 0 0 0 0 0 0 0
0 0 0 0 0 0 0 0 0 0 1 0 0 0 0 0 0 0 0 0
1 1 1 1 1 1 1 1 1 1 1 1 1 1 1 1 1 1 1 1