width 20
height 15
50.0 50.0 30.0 14.4 50.0 43.0 35.0 40.0
0 0 0 0 0 0 0 2 2 2 2 2 2 0 0 0 0 0 0 0
0 0 0 0 0 0 0 2 5 0 0 0 2 0 0 0 0 0 0 0
0 0 2 0 0 0 0 2 2 3 3 2 2 0 0 0 0 0 0 0
0 0 2 0 0 0 0 0 0 0 0 2 0 0 0 0 0 0 0 0
0 0 2 0 0 0 0 0 0 0 0 2 0 0 0 0 0 0 4 0
0 0 2 6 0 2 0 0 2 6 0 2 0 0 0 0 0 0 0 0
0 0 2 1 1 1 0 0 1 1 1 1 0 0 0 0 7 0 0 0
0 0 0 0 0 0 0 0 0 0 0 0 0 0 0 0 0 0 0 0
0 0 0 0 0 0 0 0 0 0 0 0 0 0 7 0 0 0 0 0
0 0 0 0 0 0 0 0 0 0 0 0 0 0 0 0 0 0 0 7
0 0 0 0 0 0 0 0 0 7 0 0 0 0 0 0 0 0 0 0
0 0 7 0 7 0 7 0 0 0 0 0 0 0 0 0 0 0 0 0
0 0 0 0 0 0 0 0 0 0 0 0 0 0 0 0 0 0 0 0
7 0 0 0 0 0 0 0 0 0 0 0 0 0 0 0 0 0 0 0
0 0 0 0 0 0 0 0 0 0 0 0 0 0 0 0 0 0 0 0
